{
   "DMG-NDJ": {
      "1": {
         " ": 113,
         ",": 116,
         "?": 181,
         "!": 182,
         ".": 184,
         "A": 199,
         "B": 200,
         "C": 201,
         "D": 202,
         "E": 203,
         "F": 204,
         "G": 205,
         "H": 206,
         "I": 207,
         "J": 208,
         "K": 209,
         "L": 210,
         "M": 211,
         "N": 212,
         "O": 213,
         "P": 214,
         "Q": 215,
         "R": 216,
         "S": 217,
         "T": 218,
         "U": 219,
         "V": 220,
         "W": 221,
         "X": 222,
         "Y": 223,
         "Z": 224,
         "0": 225,
         "1": 226,
         "2": 227,
         "3": 228,
         "4": 229,
         "5": 230,
         "6": 231,
         "7": 232,
         "8": 233,
         "9": 234
      }
   }
}
